000000000000000000000000000000000000000000000000000000000000000000000000000000000000000000000000000000000000000000000000000000000000000000000000000000000000000000
000000000000000000000000000000000000000000000000000000000000000000000000000000000000000000000000000000000000000000000000000000000000000000000000000000000000000000
000000000000000000000000000000000000000000000000000000000000000000000000000000000000000000000000000000000000000000000000000000000000000000000000000000000000000000
000000000000000000000000000000000000000000000000000000000000000000000000000000000000000000000000000000000000000000000000000000000000000000000000000000000000000000
000000000000000000000000000000000000000000000000000000000000000000000000000000000000000000000000000000000000000000000000000000000000000000000000000000000000000000
000000000000000000000000000000000000000000000000000000000000000000000000000000000000000000000000000000000000000000000000000000000000000000000000000000000000000000
000000000000000000000000000000000000000000000000000000000000000000000000000000000000000000000000000000000000000000000000000000000000000000000000000000000000000000
000000000000000000000000000000000000000000000000000000000000000000000000000000000000000000000000000000000000000000000000000000000000000000000000000000000000000000
000000000000000000022222222222222222222000000002220000000000000000000000000000000000000000000000000002222222222222222222000000022220000000000000000000000000000000
0000000000000000222111111111111111111112220002221122000000000000000000000000000000000000000000022222211111111111111111111222002222112000000000000000000000000000000
000000000000222211111111111111111111111112222211111220000000000000000000000000000000000000000222211111111111111111111111112222211111220000000000000000000000000000
000000000002211111111111111111111111111111111111111112200000000000000000000000000000000000002211111111111111111111111111111111111111112200000000000000000000000000
000000000022111111111111111111111111111111111111111111122000000000000000000000000000000000022111111111111111111111111111111111111111111122000000000000000000000000
000000000221111111111111111111111111111111111111111111111220000000000000000000000000000000221111111111111111111111111111111111111111111111200000000000000000000000
000000002111111111111111111111111111111111111111111111122200000000000000000000000000000002111111111111111111111111111111111111111111111122000000000000000000000000
000000002111111111111111111111111111111111111111111111111220000000000000000000000000000002111111111111111111111111111111111111111111111111200000000000000000000000
000000000211111111111111111111111111111111111111111111111120000000000006030600000000000000211111111111111111111111111111111111111111111111120000000000000000000000
000000000021111111111111111111111111111111111111111111111220000000000006030600000000000000021111111111111111111111111111111111111111111111200000000000000000000000
000000000002111111111111111111111111111111111111111111122200000000000006030600000000000000002111111111111111111111111111111111111111111122000000000000000000000000
00000000000002111111111111111111111111111111111111112222000000055555550603060000555555000000221111111111111111111111111111111111111122222000000000000000000000000
000000000000000211111111111111111111111111111112222220000000055555555006030600005555555500000022211111111111111111111111111111112222200000000000000000000000000000
00000000000000000222211111111111111111111122222200000000005555555555500603060000555555555000000002222111111111111111111111222222000000000000000000000000000000000
00000000000000000000222222111111111111222222000000000005555555555555500603060000555555555000000000022222111111111111222222000000000000000000000000000000000000000
00000000000000000000000002222222222222200000000000555555555555555555500603060000555555555500000000000000222222222222222000000000000000000000000000000000000000000
0000000000000000000000000000000000000000005555555555555555555555555550060306000055555555555555555000000000000000000000000000000000000000000000000000000000000000000
00000000000000000000000000000000000000555555555555555555555555555555500603060000555555555555555555555500000000000000000000000000000000000000000000000000000000000000
00000000000000000000000000000555555555555555555555555555555555555555500603060000555555555555555555555555555555555555555555000000000000000000000000000000000000000
0000000000000000000000000000000000000000000000000000000000000000000000060306666666666666666666666666666666666666666666666666666666666666666666666600000000000000000
666666666666666666666666666666666666666666666666666666666666666666666666030000000000000000000000000000000000000000000000000000000000000000000000000000000000000000
000000000000000000000000000000000000000000000000000000000000000000000000030000000000000000000000000000000000000000000000000000000000000000000000000000000000000000
000000000000000000000000000000000000000000000000000000000000000000000000030000000000000000000000000000000000000000000000000000000000000000000000000000000000000000
0000000000000555555555555550000000000000000000000000000000000000000000000300000000000000000000000000000000000000000000000000000000000000000000000000000000000000000
000000000055555555555555555555000000000000000000000000000000000000000000030000000000000000000000000000000000000000000000000000000000000000000000000000000000000000
000000005555555555555555555555555000000000000000000000000000000000000000030000000000000000000000000000000000000000000000000000000000000000000000000000000000000000
000000555555555555555555555555555500000000000000000000000000000000000000030000000000000000000000000000000000000000000000000000000000000000000000000000000000000000
000000555555555555555555555555555500000000000000000000000000000000000000030000000000000000000000000000000000000000000000000000000000000000000000000000000000000000
000000555555555555555555555555552200000000000000000000000000000000000000030000000000000000000000000000000000000000000000000000000000000000000000000000000000000000
000055555555555555555555555555555550000000000000000000000000000000000000030000000000000000000000000000000000000000000000000000000000000000000000000000000000000000
000055555555555555555555555555555555555555555500000000000000000000000000030000000000000000000000000000000000000000000000000000000000000000000000000000000000000000
000555555555555555555555555555555555555555555000000000000000000000000000030000000000000000000000000000000000000000000000000000000000000000000000000000000000000000
000055555555555555555555555555555555555555500000000000000000000000000000030000000000000000000000000000000000000000000000000000000000000000000000000000000000000000
000000000000000000000000000000000000000000000000000000000000000000000000030000000000000000000000000000000000000000000000000000000000000000000000000000000000000000
000000000000000000000000000000000000000000000000000000000000000000000000030000000000000000000000000000000000000000000000000000000000000000000000000000000000000000
000000000000000000000000000000000000000000000000000000000000000000000000030000000000000000000000000000000000000000000000000000000000000000000000000000000000000000
000000000000000000000000000000000000000000000000000000000000000000000000030000000000000000000000000000000000000000000000000000000000000000000000000000000000000000
000000000000000000000000000000000000000000000000000000000000000000000000030000000000000000000000000000000000000000000000000000000000000000000000000000000000000000
000000000000000000000000000000000000000000000000000000000000000000000000030000000000000000000000000000000000000000000000000000000000000000000000000000000000000000
000000000000000000000000000000000000000000000000000000000000000000000000030000000000000000000000000000000000000000000000000000000000000000000000000000000000000000
000000000000000000000000000000000000000000000000000000000000000000000000030000000000000000000000000000000000000000000000000000000000000000000000000000000000000000
000000000000000000000000000000000000000000000000000000000000000000000000030000000000000000000000000000000000000000000000000000000000000000000000000000000000000000
000000000000000000000000000000000000000000000000000000000000000000000000030000000000000000000000000000000000000000000000000000000000000000000000000000000000000000
000000000000000000000000000022222222222222222222200000000000000000000000030000000000000000000000000000000000000000000000000000000000000000000000000000000000000000
0000000000000000000000002222ppppppppppppppppppppp22220000000000000000000030000000000000000000000000000000000000000000000000000000000000000000000000000000000000000
0000000000000000000222222pppppppppppppppppppppppppppp2222000000000000000030000000000000000000000000000000000000000000000000000000000000000000000000000000000000000
00000000000022222222ppppppppppppppppppppppppppppppppppppp222200000000000030000000000000000000000000000000000000000000000000000000000000000000000000000000000000000
0000000022222ppppppppppppppppppp22222ppppppppppppppppppppppppp220000000003000000000000000000000000000000000000000000000000000000000000000000000000000000000000000
00000222pppppppppppppppppppppppp0000022ppppppppppppppppppppp222000000000030000000000000000000000000000000000000000000000000000000000000000000000000000000000000000
22222ppppppppppppppppppppppppp000000000002ppppppppppppppppppppp222200000030000000000000000000000000000000000000000000000000000000000000000000000000000000000000000
ppppppppppppppppppppppppppp00000000000000000pppppppppppppppppppppppp2200030000000000000000000000000000000000000000000000000000000000000000000000000000000000000000
pppppppppppppppppppppppppp00000000000000000002222ppppppppppppppppppppp20030000000000000000000000000000000000000000000000000000000000000000000000000000000000000000
ppppppppppppppppppppppppp000000000000000000000002ppppppppppppppppppp2200030000000000000000000000000000000000000000000000000000000000000000000000000000000000000000
2ppppppppppppppppppppppp000000000000000000000222ppppppppppppppppppppp200030000000000000000000000000000000000000000000000000000000000000000000000000000000000000000
ppppppppppppppppppppppp00000000000000000002ppppppppppppppppppppppppp2200030000000000000000000000000000000000000000000000000000000000000000000000000000000000000000
ppppppppppppppppppppp000000000000000000222pppppppppppppppppppppppppppp20030000000000000000000000000000000000000000000000000000000000000000000000000000000000000000
22pppppppppppppppppppp00000000000000002pppppppppppppppppppppppppppp22200030000000000000000000000000000000000000000000000000000000000000000000000000000000000000000
pppppppppppppppppppppp00000000000000002pppppppppppppppppppppppppppppp200030000000000000000000000000000000000000000000000000000000000000000000000000000000000000000
ppppppppppppppppppppp0000000000000000002ppppppppppppppppppppppppppp22000030000000000000000000000000000000000000000000000000000000000000000000000000000000000000000
2ppppppppppppppppppp00000000000000000022ppppppppppppppppppppppppppppp200030000000000000000000000000000000000000000000000000000000000000000000000000000000000000000
222pppppppppppppppppp00000000000000000002ppppppppppppppppppppppppppp2200030000000000000000000000000000000000000000000000000000000000000000000000000000000000000000
22222pppppppppppppp000000000000000000222pppppppppppppppppppppppppppppp20030000000000000000000000000000000000000000000000000000000000000000000000000000000000000000
22pppppppppppppppp00000000000000000000002ppppppppppppppppppppppppppp2200030000000000000000000000000000000000000000000000000000000000000000000000000000000000000000
pppppppppppppppppppp000000000000000022ppppppppppppppppppppppp22222220000030000000000000000000000000000000000000000000000000000000000000000000000000000000000000000
pppppppppppppppppppppp00000000000022pppppppppppppppppppppppppppppppp2000030000000000000000000000000000000000000000000000000000000000000000000000000000000000000000
pppppppppppppppppppppppppp00000000022pppppppppppppppppppppppppppppp22000030000000000000000000000000000000000000000000000000000000000000000000000000000000000000000
pppppppppppppppppppppppppppp0000022pppppppppppppppppppppppppppppppppp200030000000000000000000000000000000000000000000000000000000000000000000000000000000000000000
ppppppppppppppppppppppppppppp2222ppppppppppppppppppppppppppppppppppp2200030000000000000000000000000000000000000000000000000000000000000000000000000000000000000000
pppppppppppppppppppppppppppp20002pppppppppppppppppppppppppppppppppp22200030000000000000000000000000000000000000000000000000000000000000000000000000000000000000000
pppppppppppppppppppppppppppp20002pppppppppppppppppppppppppppppppp2220000030000000000000000000000000000000000000000000000000000000000000000000000000000000000000000
pppppppppppppppppppppppppppp22222ppppppppppppppppppppppppppppppppppp2200030000000000000000000000000000000000000000000000000000000000000000000000000000000000000000
2pppppppppppppppppppppppppppppppppppppppppppppppppppppppppppppppppp22000030000000000000000000000000000000000000000000000000000000000000000000000000000000000000000
22ppppppppppppppppppppppppppppppppppppppppppppppppppppppppppppppp2200000030000000000000000000000000000000000000000000000000000000000000000000000000000000000000000
222pppppppppppppppppppppppppppppppppppppppppppppppppppppppppppp222000000030000000000000000000000000000000000000000000000000000000000000000000000000000000000000000
222222ppppppppppppppppppppppppppppppppppppppppppppppppppppppp22200000000030000000000000000000000000000000000000000000000000000000000000000000000000000000000000000
2222222ppppppppppppppppppppppppppppppppppppppppppppppppppppppppp22000000030000000000000000000000000000000000000000000000000000000000000000000000000000000000000000
02222222pppppppppppppppppppppppppppppppppppppppppppppppppppppppppp200000030000000000000000000000000000000000000000000000000000000000000000000000000000000000000000
000002ppppppppppppppppppppppppppppppppppppppppppppppppppppppppp220000000030000000000000000000000000000000000000000000000000000000000000000000000000000000000000000
0000000222222ppppppppppppppppppppppppppppppppppppppppppppp22220000000000030000000000000000000000000000000000000000000000000000000000000000000000000000000000000000
0000000000000022ppppppppppppppppppppppppppppppppppppppppp222000000000000030000000000000000000000000000000000000000000000000000000000000000000000000000000000000000
000000000000000222pppppppppppppppppppppppppppppppppppppppp22000000000000030000000000000000000000000000000000000000000000000000000000000000000000000000000000000000
0000000000000000000222ppppppppppppppppppppppppppppppppp22200000000000000030000000000000000000000000000000000000000000000000000000000000000000000000000000000000000
000000000000000000000022ppppppppppppppppppppppppp22222200000000000000000030000000000000000000000000000000000000000000000000000000000000000000000000000000000000000
00000000000000000000000022pppppppppppppppppppp22200000000000000000000000030000000000000000000000000000000000000000000000000000000000000000000000000000000000000000
0000000000000000000000000022ppppppppppppppp22220000000000000000000000000030000000000000000000000000000000000000000000000000000000000000000000000000000000000000000
000000000000000000000000000022222222222222220000000000000000000000000000030000000000000000000000000000000000000000000000000000000000000000000000000000000000000000
000000000000000000000000000000000000000000000000000000000000000000000000030000000000000000000000000000000000000000000000000000000000000000000000000000000000000000
000000000000000000000000000000000000000000000000000000000000000000000000030000000000000000000000000000000000000000000000000000000000000000000000000000000000000000
444444444444444444444444444444444444444444444444444444444444444444444444430000000000000000000000000000000000000000000000000000000000000000000000000000000000000000
000000000000000000000000000000000000000000000000000000000000000000000000030000000000000000000000000000000000000000000000000000000000000000000000000000000000000000
000000000000000000000000000000000000000000000000000000000000000000000000030000000000000000000000000000000000000000000000000000000000000000000000000000000000000000
000000000000000077777777777777777777777777777777777777777777770000000000030000000000000000000000000000000000000000000000000000000000000000000000000000000000000000
000000000000000000000000000000000000000000000000000000000000000000000000030000000000000000000000000000000000000000000000000000000000000000000000000000000000000000
000000000000000077777777777777777777777777777777777777777777770000000000030000000000000000000000000000000000000000000000000000000000000000000000000000000000000000
00000000000000000000000000000000000000000000000000000000000000000000000003000000000000000000000000000000000000000000000000000000000000000000000000000000000000000
000000000000000077777777777777777777777777777777777777777777770000000000030000000000000000000000000000000000000000000000000000000000000000000000000000000000000000
000000000000000000000000000000000000000000000000000000000000000000000000030000000000000000000000000000000000000000000000000000000000000000000000000000000000000000
000000000000000077777777777777777777777777777777777777777777770000000000030000000000000000000000000000000000000000000000000000000000000000000000000000000000000000
000000000000000000000000000000000000000000000000000000000000000000000000030000000000000000000000000000000000000000000000000000000000000000000000000000000000000000
000000000000000077777777777777777777777777777777777777777777770000000000030000000000000000000000000000000000000000000000000000000000000000000000000000000000000000
000000000000000000000000000000000000000000000000000000000000000000000000030000000000000000000000000000000000000000000000000000000000000000000000000000000000000000
000000000000000077777777777777777777777777777777777777777777770000000000030000000000000000000000000000000000000000000000000000000000000000000000000000000000000000
000000000000000000000000000000000000000000000000000000000000000000000000030000000000000000000000000000000000000000000000000000000000000000000000000000000000000000
000000000000000000000000000000000000000000000000000000000000000000000000030000000000000000000000000000000000000000000000000000000000000000000000000000000000000000
000000000000000000000000000000000000000000000000000000000000000000000000030000000000000000000000000000000000000000000000000000000000000000000000000000000000000000
000000000000000088888888888888888888888888888888888888888888800000000000030000000000000000000000000000000000000000000000000000000000000000000000000000000000000000
000000000000000000000000000000000000000000000000000000000000000000000000030000000000000000000000000000000000000000000000000000000000000000000000000000000000000000
000000000000000088888888888888888888888888888888888888888888800000000000030000000000000000000000000000000000000000000000000000000000000000000000000000000000000000
000000000000000000000000000000000000000000000000000000000000000000000000030000000000000000000000000000000000000000000000000000000000000000000000000000000000000000
000000000000000888888888888888888888888888888888888888888888800000000000030000000000000000000000000000000000000000000000000000000000000000000000000000000000000000
000000000000000000000000000000000000000000000000000000000000000000000000030000000000000000000000000000000000000000000000000000000000000000000000000000000000000000
000000000000000888888888888888888888888888888888888888888888800000000000030000000000000000000000000000000000000000000000000000000000000000000000000000000000000000
000000000000000000000000000000000000000000000000000000000000000000000000030000000000000000000000000000000000000000000000000000000000000000000000000000000000000000
000000000000000888888888888888888888888888888888888888888888880000000000030000000000000000000000000000000000000000000000000000000000000000000000000000000000000000
000000000000000000000000000000000000000000000000000000000000000000000000030000000000000000000000000000000000000000000000000000000000000000000000000000000000000000
000000000000008888888888888888888888888888888888888888888888880000000000030000000000000000000000000000000000000000000000000000000000000000000000000000000000000000
000000000000000000000000000000000000000000000000000000000000000000000000030000000000000000000000000000000000000000000000000000000000000000000000000000000000000000
000000000000088888888888888888888888888888888888888888888888888000000000030000000000000000000000000000000000000000000000000000000000000000000000000000000000000000
000000000000000000000000000000000000000000000000000000000000000000000000030000000000000000000000000000000000000000000000000000000000000000000000000000000000000000
000000000000088888888888888888888888888888888888888888888888888800000000030000000000000000000000000000000000000000000000000000000000000000000000000000000000000000
000000000000000000000000000000000000000000000000000000000000000000000000030000000000000000000000000000000000000000000000000000000000000000000000000000000000000000
000000000000000888888888888888888888888888888888888888888888888800000000030000000000000000000000000000000000000000000000000000000000000000000000000000000000000000
000000000000000000000000000000000000000000000000000000000000000000000000030000000000000000000000000000000000000000000000000000000000000000000000000000000000000000
000000000000008888888888888888888888888888888888888888888888888880000000030000000000000000000000000000000000000000000000000000000000000000000000000000000000000000
000000000000000000000000000000000000000000000000000000000000000000000000030000000000000000000000000000000000000000000000000000000000000000000000000000000000000000
000000000000000000000000000000000000000000000000000000000000000000000000030000000000000000000000000000000000000000000000000000000000000000000000000000000000000000
000000000000099999999999999999999999999999990000000000000000000000000000030000000000000000000000000000000000000000000000000000000000000000000000000000000000000000
000000000000000999999999999999999999999999999000000000000000000000000000030000000000000000000000000000000000000000000000000000000000000000000000000000000000000000
000000000000000099999999999999999999999999990000000000000000000000000000030000000000000000000000000000000000000000000000000000000000000000000000000000000000000000
000000000000000999999999999999999999999999900000034444444444444444444444434444444444444444444430000000000000000000000000000000000000000000000000000000000000000000
000000000000000999999999999999999999999999900000030000000000000000000000000000000000000000000030000000000000000000000000000000000000000000000000000000000000000000
000000000000000999999999999999999999999999900000030000000000000000000000000000000000000000000030000000000000000000000000000000000000000000000000000000000000000000
000000000000000999999999999999999999999999900000030000000000000000000000000000000000000000000030000000000000000000000000000000000000000000000000000000000000000000
000000000000099999999999999999999999999999990000030000000000000000000000000000000000000000000030000000000000000000000000000000000000000000000000000000000000000000
000000000000099999999999999999999999999999900000030000000000000000000000000000000000000000000030000000000000000000000000000000000000000000000000000000000000000000
000000000000000099999999999999999999999999900000030000000000000000000000000000000000000000000030000000000000000000000000000000000000000000000000000000000000000000
000000000000099999999999999999999999999990000000030000000000000000000000000000000000000000000030000000000000000000000000000000000000000000000000000000000000000000
000000000000000000000999999999999999999900000000030000000000000000000000000000000000000000000030000000000000000000000000000000000000000000000000000000000000000000
000000000000000000000009999999999999990000000000030000000000000000000000000000000000000000000030000000000000000000000000000000000000000000000000000000000000000000
000000000000000000000000000000000000000000000000030000000000000000000000000000000000000000000030000000000000000000000000000000000000000000000000000000000000000000
000000000000000000000000000000000000000000000000030000000000000000000000000000000000000000000030000000000000000000000000000000000000000000000000000000000000000000
000000000000000000000000000000000000000000000000030000000000000000000000000000000000000000000030000000000000000000000000000000000000000000000000000000000000000000
000000000000000000000000000000000000000000000000030000000000000000000000000000000000000000000030000000000000000000000000000000000000000000000000000000000000000000
000000000000000000000000000000000000000000000000030000000000000000000000000000000000000000000030000000000000000000000000000000000000000000000000000000000000000000
000000000000000000000000000000000000000000000000030000000000000000000000000000000000000000000030000000000000000000000000000000000000000000000000000000000000000000
000000000000000000000000000000000000000000000000030000000000000000000000000000000000000000000030000000000000000000000000000000000000000000000000000000000000000000
000000000000000000000000000000000000000000000000030000000000000000000000000000000000000000000030000000000000000000000000000000000000000000000000000000000000000000
000000000000000000000000000000000000000000000000030000000000000000000000000000000000000000000030000000000000000000000000000000000000000000000000000000000000000000
000000000000000000000000000000000000000000000000030000000000000000000000000000000000000000000030000000000000000000000000000000000000000000000000000000000000000000
000000000000000000000000000000000000000000000000030000000000000000000000000000000000000000000030000000000000000000000000000000000000000000000000000000000000000000
000000000000000000000000000000000000000000000000034444444444444444444444444444444444444444444430000000000000000000000000000000000000000000000000000000000000000000
000000000000000000000000000000000000000000000000000000000000000000000000000000000000000000000000000000000000000000000000000000000000000000000000000000000000000000
000000000000000000000000000000000000000000000000000000000000000000000000000000000000000000000000000000000000000000000000000000000000000000000000000000000000000000
00000000000000000000000000000000000000000000000000000000000000000000000000000000000000000000000000000000000000000000
000000000000000000000000000000000000000000000000000000000000000000000000000000000000000000000000000000000000000000000000000000000000000000000000000000000000000000
000000000000000000000000000000000000000000000000000000000000000000000000000000000000000000000000000000000000000000000000000000000000000000000000000000000000000000